#############
#.#########.#
## ####### ##
### ##### ###
#### ### ####
##### # #####
######R######
##### # #####
#### ### ####
### ##### ###
## ####### ##
#.#########.#
#############