#####################
#               .   #
#  .##              #
#  #      R         #
#  #                #
#       XXXX        #
#       XXXX        #
#  .    XXXX        #
#                #  #
#          .     #  #
#     .        ##.  #
#                   #
#####################