#####################
#  XX #R#     #     #
## ## # #.# #.#.# #.#
#       ### ##### ###
## ####            X#
#.   .# ### #########
## #### #.# #.     .#
#.      # # ### #####
### ###   #        .#
#X# #.### ##### #####
# # #   # ##### ... #
#     ###    .# ... #
#####################